Fecha,Descripcion,Movimiento,Debitos,Creditos,Saldo
02/05/2023,Combustible,4870400,-75000,0,20933519
02/05/2023,Pago tarjeta,4986206,-100000,0,20833519
02/05/2023,Super,5833469,-89500,0,20744019
02/05/2023,Nasa,6061994,-600000,0,20144019
02/05/2023,Transaccion,6128397,-700000,0,19444019
02/05/2023,Transaccion2,6545878,-25000,0,19419019
