Fecha,Descripcion,Movimiento,Debitos,Creditos,Saldo
02/05/2023,Combustible,4870400,"-75.000,00","0,00","20.933.519,00"
02/05/2023,Pago tarjeta,4986206,"-100.000,00","0,00","20.833.519,00"
02/05/2023,Super,5833469,"-89.500,00","0,00","20.744.019,00"
02/05/2023,Nasa,6061994,"-600.000,00","0,00","20.144.019,00"
02/05/2023,Transaccion,6128397,"-700.000,00","0,00","19.444.019,00"
02/05/2023,Transaccion2,6545878,"-25.000,00","0,00","19.419.019,00"
